....................
.+----------------+.
.|                |.
.|  @    +---+    |.
.|       |...|    |.
.|       |...| E  |.
.|       +---+    |.
.|            E   |.
.+----------------+.
....................